A young girl is dancing	A young girl is standing on one leg
A man is falling off a surfboard in the water	A surfer is riding the wave
A man is walking in the rain	It is raining on a walking man
A white dog is approaching a golden dog on pebbly beach	Two dogs are playing on a rocky beach
A man and a woman are walking together through the woods	A man and a woman are walking through a wooded area
A woman is slicing a carrot	A potato is being sliced by a woman
A little boy, who looks fearful, is on a climbing wall.	A boy is climbing up a wall artificially built for climbing and is attached to a rope
A dog is herding a pack of white sheep on a dusty farm	A dog is scattering a pack of white sheep on a dusty farm
A man in a red uniform is making a jump in a dirt bike race	There is no man in a red uniform making a jump in a dirt bike race
Two men in a race are flipping the tires of a tractor	Two men are competing in a tire rolling race
A girl is wearing white clothes and is dancing	A girl in white is dancing
There is no woman being kissed by a man	A woman is being kissed by a man
The woman is measuring the other woman	A woman is being measured by another woman
A black and white dog is carrying a huge stick on the green grass	A black and white dog with a large branch is running in the field
A man is playing a trumpet	The man is playing a guitar
A cat is jumping high into the air in the country	A dog is jumping in the shade of some trees
One man is doing floor exercises	A man is doing exercises
The man dressed in leather chaps and a purple shirt is standing in front of someone lookers	A man is wearing a purple shirt and black leather chaps and is posing for the camera
A girl is standing in a group and is wearing a black shirt and pink beads	A girl has colored patches on the cheeks
A hole is being burrowed by the badger	A badger is shrewdly digging the earth
There is no boy playing outdoors and there is no man smiling	The young boys are playing outdoors and the man is smiling nearby
Nobody is playing the guitar	A man is playing the guitar
A kid is playing guitar	A woman is playing an electric guitar
The tall person is setting fire to the cameras	A person is burning some cameras with a blow torch
One man is riding a horse	A man is riding a horse
A man and a woman are driving down the street in a jeep	A man and a woman are driving down the road in an open-air vehicle
A man and two women in a dark room are sitting at a table with candles	The group of people is sitting in a dim room
A little boy is wearing a yellow tank top and is laughing	A laughing boy is in a yellow tank and is wearing a top
A woman is slicing potatoes	A horse is being ridden by a person
A man is skiing down a hill and jumping a red obstacle	A man is snowboarding down a railing in the snow
A woman is dancing and singing with other women	A woman is dancing and singing in the rain
A grey silky dog is lying in the grass and a brown dog is looking on	The brown dog is spotting a black dog lying in the dry grass
A man is singing and playing a guitar	A man is singing and playing a musical instrument
There is no woman using an eye pencil and applying eye liner to her eyelid	A woman is applying cosmetics to her eyelid
A laughing child is holding a water gun and getting sprayed with water	A person in a blue jacket is jumping onto a tall cement wall
The person is setting fire to the cameras	A person by some cameras is blowing on a burning torch
A biker with a blue jacket, black pants and a white helmet is driving on dirt and people are watching	The rider on the blue and black motocross bike is not wearing the pants
A group of football players is standing still in the field	The crowd is watching a football game
A man is drawing	There is no man drawing
A few men in a competition are running outside	A few men are running competitions outside
A boy in a white t-shirt is splashing in shallow water	A boy is running through the water at the beach
The man is not stirring the sauce for the chicken	The man is stirring the sauce for the chicken
A person is playing a guitar and singing	One person is playing the guitar and singing
A woman is planting some flowers	A woman is cutting broccoli
A keyboard is being played by a man	A man is playing a harp
Someone is cooking okra in a pan	Okra is being cooked in a pan
A dog is playing with a toy	A dog is eating a doll
A guy is leaping into the air in wood	A guy is leaping into the air in a wooded area
A dog is jumping in the shade of some trees	A dog is jumping into the air in the country
A child is running in and out of the ocean waves	A child is running in and out of the waves of the ocean
A woman is using a pencil for eyes and is applying eye liner to her eyelid	A woman is applying cosmetics to her eyelid
A biker with a blue jacket, black pants and a white helmet is driving on dirt and people are watching	The motocross rider is standing naked
The person is not standing on white ice	A person is standing in a vast field of glacial ice
A baby is playing with a toy	A baby tiger is playing with a ball
Some cheerleaders are relaxing	A female cheerleader is sitting on the knee of a male cheerleader
The blond girl is dancing in front of the sound equipment	A girl in white is dancing
Two people are driving a jeep and a girl is sitting on the top of it	Two people are driving a jeep and a lady is sitting on the top of it
A woman is playing a guitar	A talented man is playing the guitar
The man is not slicing the potato	The man is slicing a potato
Boys are dancing in front of some people	Boys are not dancing in front of some people
The woman in a red costume is leaning against a brick wall and playing an instrument	The woman in a red costume is not leaning against a brick wall and is not playing an instrument
A tower is being looked at by a blonde lady	A woman is looking at the view of a city
A boy is playing guitar	There is no boy playing guitar
A dog is playing alone on a beach covered by snow	A dog is walking along a snowdrift
Two dogs are playing together on the grass	Two dogs are resting together in the grass
Two teenage girls are wearing fancy dresses at an event	Two girls in their teens are wearing fancy dresses at an event
A brown dog is running across the yard with a toy in its mouth	There is no brown dog running across the yard with a toy in its mouth
A brown and white dog is running through the tall grass	A brown and white dog is moving through the wild grass
A man is emptying a container made of plastic	A man is emptying a container made of plastic completely
The doctors are healing a man	The doctor is helping the patient
A man is walking down a road	A man from the wilderness is on a walking path
A man is exercising	There is no man exercising
A girl in a band is playing an instrument	The dog is snapping at some droplets of water
A man is rock climbing, pausing and calculating the route	A man is rock climbing, stopping and calculating the route
The man is removing knives from a tree	The man is throwing knives at a tree
There is no man running, jumping and kicking near a vending machine	Three young men are running, jumping and kicking near a vending machine
A dog is eating a doll	There is no dog playing with a toy
A woman is parking a blue bicycle and is wearing lots of riding helmets	A woman is wearing a blue helmet and is riding a bicycle in a parking lot
Noodles are being boiled in water by a woman	A woman is boiling noodles in water
A dog is licking a baby	The dog is licking the baby
A small white dog is running across a lawn	A big white dog is running across a lawn
The monkey is brushing a bull dog	A bull dog is brushing the monkey
A black and white dog is dropping a baseball from its mouth	A brown and white dog is holding a baseball in its mouth
The man is not hiking in the woods	A man is trekking in the woods
There is no man playing a flute	A man is playing a large flute
The bunch of men are playing rugby on a field full of mud	Some men are playing rugby
Two small children are playing with a toy car in the street	A dog is running through a field and is chasing a toy
A monkey is teasing a dog at the zoo	There is no monkey teasing a dog at the zoo
A kid in a white t-shirt is splashing in shallow water	A boy is running through the water at the beach
The snowboarder is doing a flip over a mound of snow	Somebody is jumping in the air on a board
The lady is picking up the kangaroo	The woman is picking up the kangaroo
A race car driver is sitting down and is motionless	A race car driver is standing up and pointing his hand at the sky
The person is not slicing a clove of garlic into pieces	The person is slicing a clove of garlic into pieces
The woman is erasing the drawing on the board	The man is erasing the drawing on the board
Some dangerous men with knives are throwing a bike against a tree	A man is dangerously throwing knives at a tree
A man is dancing on the road	A biker is riding away from a fence
A black dog on a leash is walking in the water	The dog is on a leash and is walking near the water
A large green ball is hitting a potato	A big green ball is missing a potato
A woman is dancing	The man is not dancing
No dog is in the sand that is blowing in the wind	A dog is in a sandy area with the sand that is being stirred up into the air and several plants are in the background
An onion is being sliced with a knife by the woman	A man is preparing some dish
Two dogs are looking at something that is splashing in the water	Some dogs are not playing in a stream
A boy, who is wearing a blue coat, is being held by his father under an umbrella 	A boy under an umbrella is being held by his father who is wearing a blue coat
A woman in jeans is sitting on the saddle of a horse	A person wearing jeans is sitting happily on the top of a horse saddle
A girl in white is dancing	The equipment in front of the blond dancing girl is sound
An elder man is sitting on a bench and is wearing a gray jacket and black pants	An elderly man is sitting on a bench
A man is laying down a guitar	A man is playing a guitar
A boy is holding a hose next to a man and another boy is watching	A child is watching someone playing outdoors and is spouting water over the rest of his family 
The man is speaking on the telephone	The man is talking on the telephone
A group of people are standing around a sound mixing table	Some people is looking at sound equipment
A horse is being ridden by a woman	A woman is riding a horse
A boy is filling a pitcher with water	A pitcher is being filled with water by a boy
A dog is in the sand that is blowing in the air	A dog is in a sandy area with the sand that is being stirred up into the air and several plants are in the background
A white dog is standing on fallen leaves	A white dog is lying on fallen leaves
A person is playing a guitar and singing	One person is playing the guitar and singing
The woman wearing silver pants, pink bellbottoms and a pink scarf is riding a bike	A pedestrian woman is building pink bicycles for boa wearing riders
A woman is rocking over a blanket lying on someone reading a book	A woman on a rock is lying on a blanket and reading a book
The cop is sitting on a police bike	The animal is grazing on the grass
A practicing jumper is tossing a person's snowboard into the air	Two people are riding a bike
A dog is jumping on a trampoline	A dog is bouncing on a trampoline
A large flute is being played by a man	A man is playing a flute
A man is playing an electric guitar	A man is playing guitar
The kids are not wearing suits and water is splashing around	Children in swimming suits are playing in the water
The picture of a camera set up is being taken by a man on the beach at the sunset	A man is taking pictures of a lake
A white dog is approaching a golden dog on pebbly beach	Two dogs are playing on a rocky beach
A snake is being fed a mouse by a man	No snake is being fed a mouse by a man
A woman is slicing a potato	A woman is cutting a potato
A panda bear is eating some bamboo	Some bamboo is being eaten by a panda bear
There is no man spraying a super soaker into the mouth of a dog	A man is spraying a super soaker into the mouth of a dog
A man is reloading a shotgun	A man is firing a shotgun
A big green ball is missing a potato	A big green ball is knocking a potato
The turtle is following the fish	A fish is hunting for a turtle in the sea
A man with no hat is sitting on the ground	A man with a backwards hat is sitting on the ground
A tennis player is jumping to the left	A tennis player is lunging to the left
A young girl in a blue leotard is jumping in the air	A young girl in a leotard colored in blue is jumping in the air
There is no hockey player in a yellow jersey guarding the goal	The ice hockey goalkeeper is wearing a yellow jersey and is defending the goal
A yellow dog is chasing a ball	A dog is turning on the grass and pursuing a flying tennis ball
A man is wearing a blue shirt and walking barefoot on a tennis court	A woman is wearing a blue shirt and walking barefoot on a tennis court
A man is hurriedly getting into a car in a garage	A man is getting into a car
The cat is playing passionately with a watermelon	A cat is playing with a watermelon
A man is standing on a boat in front of the sunset near a flag	A man is sitting on a boat in font of the sunset, near a flag
The man in blue is posing for a picture next to a vehicle	A man is standing at the wheel of a classic American car that has its door and trunk open
The lady is penciling on eyeshadow	The woman is penciling on eyeshadow
A biker is wearing gear which is black	A biker wearing black is breaking the gears
A band is playing on a stage	A band is playing onstage
A big brown dog and a small grey dog are standing on a rocky surface	A large brown dog and a small grey dog are standing on a rocky surface
A girl is skipping rope on a sidewalk	A girl is skipping rope on near a street
A horse and its rider are leaping over a barrier	A hurdle is being leapt by a horse that has a rider on its back
The girl, who is little, is carefully combing her hair into a pony tail	The girl, who is little, is combing her hair into a pony tail.
A man and a woman are in a room painted beige, wearing dark colored shirts and a monitor is in the background	A man and a woman are in a beige room, wearing dark colored shirts and a monitor is in the background
A boy is standing outside the water	The boy is wading through the blue ocean
The guitar is being played by the man	A boat is sailing peacefully over the water
The person is slicing onions	Onions are being sliced by the person
The man is not doing exercises	The man is doing exercises
A small child is showing excitement on a swing set at the park	The girl, who is little, is swinging and the woman is standing behind
Men are sawing logs	Men are cutting wood
Five children are standing in a wooden hut	Five children are standing in front of a wooden hut
A woman is cooking a breaded pork chop	The woman is chopping some bread and fried pork
The girl is sitting on the couch and is crocheting	There is no girl playing the violin on a beach
The adults and children are not gathered near an outdoor seating arrangement	The adults and children are being gathered near an outdoor seating arrangement
A black and orange bird is standing in the grass	The black bird with a yellow beak is standing in the green grass
A woman is riding a water scooter	A woman is riding a scooter for water
The man is going into the water	The person is going into the sea
There is no woman combing her hair	A woman is combing her hair
An animated airplane is taking off	A plane is landing
There is no man cooking a snake	A man is cooking a snake
A woman is wearing a blue shirt with a white vest and a white cap and is talking and marching	The woman wearing the blue and white uniform with a white and blue hat is keeping her mouth open and is near others who are dressed in the same fashion
A white and tan dog is running through the tall and green grass	A white and tan dog is running through a field
People are riding and paddling a raft	A few people are floating on a raft
The group of people is sitting in a dim room	The group of people is sitting in a room which is dim
A girl is eating a cupcake	A cupcake is being eaten by a girl
The kid is happily sliding in the snow	A boy on a hill covered in snow is wearing a red jacket and a black hat and is sliding on his knees
A woman is putting two eggs into a pot of water	A woman is placing two eggs into a pot of water
A woman is putting on makeup	There is no woman putting on makeup
A small group of people are standing and two are sitting on the sofa	A group of five young adults are lounging indoors
Two men with cars are on the side of a snowy road	Two men are taking a break from a trip on a snowy road
A man in a motocross uniform is wearing a helmet and rides a red motorcycle	A person in a motocross uniform is wearing a helmet and rides a red motorcycle
Three boys in karate costumes are fighting	Three boys in karate costumes aren't fighting
A little girl and a woman wearing a yellow shirt are getting splashed by a city fountain	A young girl is playing on the edge of a fountain and an older woman is watching her
A small boy is scolding a dog	A small boy is playing with a dog
The woman isn't stirring eggs in a bowl	Someone is beating an egg
A tan dog is running through the brush	There is no white dog with beige spots running through a field
A man is playing a guitar	There is no man playing a guitar
A horse is being ridden by a person	A person is riding a horse
A veteran is showing different things from a war to some people	A large man is sitting in a military accessories store
The dog is having a nap in the park	A big brown and white spotted dog is lying on a jacket on the street
A woman is playing the violin	There is no man playing the piano
The kittens on the trays are being eaten as food for an advertisement	The food on the trays is being eaten by the kittens
A group of people is equipped with gear used for protection	A group of people is equipped with protective gear
A man is wearing a straw hat and smoking a cigarette	A cigarette is being smoked by the man in the straw hat
No group of people is gathering at a stand at the fair	The people are standing at a carnival
A big cat is opening a plastic drawer with its paws and is jumping inside	A cat is opening a drawer and jumping inside
Some people and vehicles are on a crowded street	Some people and vehicles are on a almost empty street
Two children are playing on a statue	Small children are climbing a statue in a park
Someone is strumming the guitar	Someone is playing the guitar
A cook is coating a pork chop	A woman is grating carrots
A dog is swimming after a tennis ball	A young man is pushing a motocross bike down a dirt hill
A man is climbing a rope	The man is climbing up a rope
A group of rollerbladers is lining up on the road	A group of rollerbladers is lining up on the street
A karate practitioner is kicking at another man who is wearing protective boxing gloves	There is no karate practitioner kicking at another man who is wearing protective boxing gloves
Rugby players are not tackling each other	A soccer player is being tackled by his opponent
A skateboarder is jumping in the air	The skateboarder is jumping in the air
A golden dog is running through a field of tall grass	There is no brown dog running through tall green grass
An adult is in the amphitheater and is talking to a boy	There is no adult in the amphitheater talking to a boy
There are no racers running down a track	Racers are running down a track
A black and white dog with a large branch is running in the field	A black and white dog with a large branch is standing in the field
A little boy in a pink shirt is running under a tree in the desert	A girl is wearing jeans and a pink shirt and is running
A cluster of four brown dogs are playing in a field of brown grass	Four dogs are not playing in a grassy area
A man is recklessly climbing a rope	A man is climbing a rope
A man is driving a car	There is no man driving a car
A man in a black jersey is standing in a gym	A man in a jersey which is black is standing in a gym
A tennis player is jumping to the left	A tennis player is lunging to the left
Three boys are walking on rocks along a river	Three boys are resting on rocks along a river
Ferrets are climbing down from a shelf	A few ferrets are climbing out of the cage
A man is screaming	A sad man is crying
A woman is playing an electric guitar	A man is laying down a guitar
The people are not sitting on a bench in front of a restaurant	Three people are sitting on a bench under some palm trees
A band is not playing some instruments	A band is playing some instruments
People at a drag race are running away from the flames that are coming out of the cars	The crowd is watching two racing cars that are leaving the starting line
A boy in a white t-shirt is splashing in shallow water	A girl is running through the water at the beach
A woman dressed in elegant clothing is inside a crowd of people and is looking down	A woman dressed in elegant clothing is inside a crowd of people and is looking up
The man at the beach is not doing a handstand on the wet sand at the edge of the water	The man is doing a handstand on the wet sand at the edge of the water at the beach
A bald person is playing a guitar	A person has blonde and flyaway hair and is playing a guitar
The man is singing and playing the guitar	The guitar is being played by a man
A football player in a purple jersey is running with the ball for a touchdown	A football player is carrying an official past a rolling football
The woman is holding the paintbrush next to the artist's easel 	The lady is holding the paintbrush next to the artist's easel 
A man dressed in black is wearing an elaborate black mask	There is no man dressed in black wearing an elaborate black mask
A man is doing a trick on a skateboard	A person is doing a trick on a skateboard
The woman is cleaning a shrimp	A woman is cleaning a shrimp
A dog is swimming in a body of water	An animal is swimming in a body of water
A man is playing an electric guitar	A man is playing guitar
Vegetables are being put into a pot by a man	Someone is pouring ingredients into a pot
A young boy is playing a wind instrument	A kid is throwing away an instrument
A man is leaning on the ledge of a balcony	A woman is leaning on the ledge of a balcony
A motorcycle is riding standing up on the seat of the vehicle	Someone is on a black and white motorcycle and is standing on the seat
A practicing jumper is tossing a person's snowboard into the air	Two people are riding a bike
A person is looking at a bike designed for motocross that is lying on its side and another is racing by	The bike rider is looking at an accident of another bike rider
There is no football player in a purple jersey running with the ball for a touchdown	A football player is running past an official carrying a football
A toy train is striking a toy car	A toy train is missing a toy car
A toddler is making a splash inside a blue paddling pool	The child is splashing water in a big red pool
A woman is refrigerating a potato	A woman is peeling a potato
The horse is being ridden by a man	A man is riding the horse
The man is not doing exercises	Two men are fighting
The little boy is sticking his tongue out for the camera and another boy is looking on	Two young boys are looking up at the camera and one is sticking out his tongue
A few men in a competition are running outside	A few men in a competition are running indoors
A person is eating in a restaurant	A person is making a bed
A race car driver is standing up and is fiercely pointing his hand at the sky	The person in the blue jacket is wearing a colorful helmet
A girl is eating a cupcake	A cupcake is being eaten by a girl
A lady is cutting up some meat precisely	Some meat is being cut into pieces by a woman
Not a lot of people are in an ice skating park	An ice skating rink placed outdoors is full of people
The man is hurling knives at a tree	The man is throwing knives at a tree
A dog is running breathlessly on the road	A dog is running on the road
Nobody is standing in the ocean and watching the sunset	Two people are standing in the ocean and watching the sunset
Three men are practicing karate outdoors	Three boys in karate costumes are fighting
There is no boy walking across a bridge	A boy is walking across a bridge
A young girl in a bikini is jumping on the beach	A young girl in swimming suite is jumping on the beach
A dog is running with a ball	The black dog is carrying a blue and white ball in its mouth
A big fish is catching a man	A woman is deboning a fish
Four people are walking along a city sidewalk and the one in the green hat is phoning someone	A group of people is walking down the street and a person in a green hat is on the phone
The man is tossing a kid into the swimming pool that is near the ocean	A man isn't tossing a kid into the swimming pool that is near the ocean
Nobody is slicing a tomato	The person is slicing a vegetable
There is no man drawing a picture	A man is drawing a picture
A man is cutting a note	A man is cutting a paper
Two white dogs are quickly running together	Two white dogs are running together
The lady is slicing a tomato	Someone is cutting a tomato
There is no woman slicing a fish	A woman is slicing a fish
A snowboarder is grinding down a long concrete rail	A person is doing acrobatics on a snowboard
A man is applying a silencer to a gun	A man is fitting a silencer to a pistol
Two white dogs are playing with a brown dog and a tennis ball	Two white dogs are playing with a brown dog and a ball
A small guinea pig is gnawing and eating a piece of carrot on the floor	A guinea pig is devouring a carrot
A man is climbing a rope	A man is climbing up a rope
A bull dog is being brushed by the monkey	The monkey is brushing a bull dog
A man is dancing on the ceiling of a room	The man is dancing upside-down on the ceiling
A woman is driving a car and is talking to the man who is seated beside her	There is no woman driving a car and talking to the man seated beside her
A black dog and a small white and black dog are looking up at a kitchen countertop	A large dog and a small dog are standing next to the kitchen counter and are investigating
A woman is taking off a cloak, which is very large, and revealing an extravagant dress	A woman is putting on a cloak, which is very large, and concealing an extravagant dress
A man is chopping a log with an axe	The man is chopping a tree trunk with an axe
A child is swimming underwater in a pool	A child is smiling at the camera and swimming underwater
A man is doing back flips on a trampoline	Several boys are jumping on a trampoline
An old, topless woman is covered in paint	A young, topless woman is covered in paint
A black dog is running in the grass and its tongue is hanging out	A black dog is running in the grass
A man is wearing a blue shirt which has long sleeves and jeans and is riding a unicycle down a street	A man is wearing a blue checkered shirt and riding a unicycle in the street
A person is cutting some ginger	There is no person cutting some ginger
Swimmers are racing in a lake	Some racers are swimming in a lake
A man is cutting onions	A woman is cutting an onion
A man is running on the road	A dog is running breathlessly on the road
A person is peeling a potato	A potato is being peeled by a person
A guinea pig, which is small, is gnawing and eating a piece of carrot on the floor	A small guinea pig is gnawing and eating a piece of carrot on the floor
A rollerblader is performing a trick on a ramp	A trick is being performed by a rollerblader on a ramp
A man is playing a flute	A man is not playing a flute
A girl in blue is sliding down a green slide	The young girl in blue is enjoying a slide
A group of scouts are hiking through the grass	A group of explorers are walking through the grass
A family is buying something at the vending machine	A man in a suit is standing at a microphone and singing
A tower is being looked at by a blonde lady	A woman is looking at the view of a city
Two bmx bikers are jumping dirt ramps in front of a body of water	There is no bmx biker jumping dirt ramps in front of a body of water
A large green ball is hitting a potato	A large green ball is missing a potato
Some corndogs are being eaten by two toddlers who are in a wagon, which is really small	Two toddlers are eating corndogs in a wagon, which is really small
A man is standing on a boat in front of the sunset near a flag	A man is on a boat in front of the sunset
The white reindeer wearing dog ears is near a brown reindeer	A white dog is wearing a Christmas reindeer headband and is playing with a brown dog in the grass
A man in green is kicking a soccer ball and a man in purple and white is rising up	The players is maneuvering for the soccer ball
Two large dogs, a light colored one and a dark one, are sleeping on a snowy terrain	Two dogs are leaping through snowy grass and rocks
A flute isn't being played by a man	A man is playing the guitar loudly
The girl, who is little, is swinging and the woman is standing behind	The little girl is swinging and the woman is standing behind her
Three women are dancing	A few women are dancing
A man is playing a wooden flute	There is no man playing a wooden flute
A man is standing near a bike and is writing on a piece paper	A man is sitting near a bike and is writing a note
A child in light colored clothing is standing with his arms extended outward	A child in clothing which is light colored is standing with his arms extended outward
The man is lifting barbells	The man is lifting weights
A woman is taking a mixture out of a bowl	A woman is preparing an egg in a skillet
A boy is filling a pitcher with water	A woman is collecting the water from a tap in a mug
A man is practicing the drum	A man is playing the drum
A waterfall is flowing into a shallow pool	The people are walking on the road beside a beautiful waterfall
A man and a woman are walking together through the woods	A man and a woman are hiking through a wooded area
A white man is walking next to a building in a big city	A black man is walking next to a building in a big city
The lady is slicing a tomato	There is no one cutting a tomato
A man is flooring a sitting guitar player	A man is sitting on the floor in a room and strumming a guitar
Three young men are furiously running, jumping and kicking near a vending machine	Three men are jumping off a wall
A dog is leaving a ball in the dirt	A dog is chasing a ball through dirt
A group of people are marching	A group of people are dancing in a show
The microphone in front of the talking parrot is being muted	The parrot is talking into the microphone
A woman is using a machine made for sewing	A woman is sewing with a machine
A girl in white is dancing	There is no girl in white dancing
The woman is slicing cooked octopus	A woman is chopping up an octopus
A boy is playing a piano	There is no man singing and playing a guitar
A snow ball is being made by a child	A kid in orange is playing outside with a snowball
A man is rowing a canoe	A man is rowing a boat
The elephant is being ridden by the woman	A person is slicing some mushrooms
A woman is slicing a pepper which is green	A woman is slicing a green pepper
There is no boy checking a calendar	A boy is looking at a calendar
A man is cutting a thick rope with a sword	There is no man cutting a rope with a sword
A group of people is holding drinks and pointing at the camera	A man is playing an electric guitar
The man is sprinkling cheese on the pizza	The cook is sprinkling cheese on the pizza
A young mother is playing with her boy in the park	A young boy is playing in the park with his mother
A boy in a white t-shirt is splashing in shallow water	A girl is running through the water at the beach
A woman is putting away carrots	A woman is coating a pork chop
Two sumo wrestlers are fighting	Two sumo ringers are fighting
A surfer is surfing a huge wave	A surfer is surfing a big wave
A crowd of people is near the water	A group of children in uniforms is standing at a gate and there is no one kissing the mother
The woman is not wearing a red jacket and is not holding a glass in front of the man in a white t-shirt	A person is wearing a red jacket and holding a beer
A man is slicing a tomato	A man is slicing a bun
A young girl in a blue shirt is walking on the sidewalk and holding up a pink sign	A young girl by a pink sign is holding up a blue shirt and is walking on the sidewalk
A man is scared	A man is screaming
A young girl is wearing a blue patterned swim suit, a black and yellow swim cap and has blue swimming goggles on her head	A little girl is wearing a blue patterned swim suit, a black and yellow swim cap and has blue swimming goggles on the head
Two men are outside a cattle pen	Two men are fighting in a cattle pen
Two dogs are running through water	Two dogs are running through high grass
A man in a black jersey is standing in a gym	A man is standing in a gym and is wearing a jersey
One man is climbing a cliff with a rope	A person with pink climbing gear roped the rock
A woman is dancing and singing with other women	A woman is dancing and singing alone
There is no man opening a box with a knife	A man is opening a box with a knife
A man is parking a car in a garage	A man is getting into a car
The lady is slicing up the meat	The lady isn't cracking an egg for the mixer
Two dogs are playing by a tree	Two dogs are playing by a plant
A man is carelessly holding a frog	A man is emptying a container made of plastic
A man is lazily walking down a road	The man is walking along a path through the wilderness
Two young girls are wearing hats and sticking their colored tongues out	Two kids are sticking out blue and green colored tongues
No lady is standing on the street and is surrounded by school children	A woman in blue jeans is standing in front of a group of children beside a stone built house
A man is packing the guitar	The man is singing and playing the guitar
A little child in a pink sweater is climbing a concrete staircase	A small child is outdoors climbing steps in a grassy area
The person is scrubbing a zucchini	A person is scrubbing a zucchini
An onion is being sliced by a woman	The woman is cutting a carrot
A surfer is riding a big wave across dark green water	The surfer is riding a small wave
A bicyclist is holding a bike over his head in a group of people	A cyclist is being held over the heads of a group of people with the bike
A young woman with Indian clothing and henna on her hand is going through paperwork	A woman is wearing a colorful shirt and a lot of jewelry
A man is slicing a potato into pieces	A man is not cutting a potato
An officer is talking to the recruits	Recruits are talking to an officer
A girl in blue sweater is holding a multicolor toy and is sitting on the shoulders of an old man with grey hair	A girl in blue sweater is holding a multicolor toy and is sitting on the shoulders of a man with grey hair
A hiker is on top of the mountain and is doing a joyful dance	A hiker is on top of the mountain and is dancing
The man is tossing a kid into the swimming pool that is near the ocean	A man isn't tossing a kid into the swimming pool that is near the ocean
A man is playing a guitar	A man is strumming a guitar
A young, topless woman is covered in paint	Some instruments are being played by a band
A child is experiencing a new world	A boy under an umbrella is being held by his father who is wearing a blue coat
A flute is being played by a man	The adult is playing the guitar loudly
A man is breaking tiles with his hands	There is no man breaking wooden boards with his hand
A man is spitting	A man is talking on the radio
Garlic is being chopped by a woman	A woman is chopping garlic
A man is standing on the top of the rocks with clouds behind them	Somebody is standing on a mountain top
A dog next to a tree, which is probably a pine, is biting a bucket	A dog which is furry and black is in a back yard and is carrying a basket in its mouth
The people are not sitting on a bench in front of a restaurant	Three people are sitting on a bench under some palm trees
The group of people is standing together and looking at the camera	A group of people is standing together and looking at the camera
A young child is splashing in the water	The small child is walking through the water and is being guided by another person
Two dogs are playing in a forest	A brown dog is running after a black dog on a rocky shore
A yellow dog is running on white snow on a very sunny day	A yellow dog is running on white snow on a sunny day
Four athletes are with a woman in a crowded stadium	A person in a pink jacket is running onto the field
The woman is holding a whole tomato	Someone is cutting a tomato
Two sumo ringers are fighting	A man is riding a water toy in the water
A group of people is singing	Some people are singing
A flute is being played in a lovely way by a girl	A flute is being played by a girl
A woman is pouring ingredients into a bowl	The chef is seasoning the oil
There is no brown dog standing in the water	A dog with golden fur is in the water
Two kids are looking up at the camera and one is sticking out his tongue	A little boy is sticking his tongue out for the camera and another boy is looking on
A woman is playing a flute	The woman is not playing the flute
Two teams are competing in a football match	A player is throwing the ball
A woman is playing the flute	A man is playing a flute
A woman is tapping her fingers	A woman is resting her fingers on a table
Some ingredients are being mixed in a bowl by a person	Some ingredients are being separated in a bowl by a person
A monkey is teasing a dog at the zoo	A monkey is pulling a dog's tail
The food on the trays is being eaten by the kittens	A few kittens are eating
The woman is not putting pasta into a dish	A woman is pulling some sticky goo out of a bowl
A man is doing pull-ups	The man is doing exercises in a gym
A grey dog is bouncing a soccer ball on its head in a grass field	A dog with a blue collar is playing with the ball outside
A girl is practicing the piano	A little girl is playing a grand piano on stage
A man is not rock climbing and a city and a bay are in the background	A man is rock climbing and a city and a bay are in the background
A woman is exercising	A person is dancing
A woman, who is old, is near a white dog	A woman and a dog are sitting on a tree stump
A blonde boy in green is sitting on a swing	There is no little girl with blond hair smiling and sitting on a swing
A woman is riding a horse	A man is opening a small package that contains headphones
The girl has red hair and eyebrows, several piercings in a ear and a drawing on the back	The girl has red hair and eyebrows, several piercings in a ear and a tattoo on the back
One man is sitting on the chair	The girl, who is little, is ruffling her hair
There is no man eating food	A man is eating a pizza
A woman is buttering a piece of bread	A man is buttering a piece of bread
A group of boys is playing soccer on the beach	A group of men is playing soccer on the beach
A man in a white shirt and sunglasses and a man in a black shirt and sunglasses are sitting at a table with four beer bottles	A man in a white shirt and sunglasses and a man in a black shirt and sunglasses are sitting at a table with four bottles of beer
The woman is putting pasta into a dish	Pasta is being put into a dish by a woman
Two dogs of different breeds are looking at each other across a street	One white dog is staring at the black street
A skateboarder is jumping off a ramp	A skateboarder is making a jump off a ramp
The woman is not putting pasta into a dish	A woman is pulling some sticky goo out of a bowl
An elegant woman is inside a crowd of people and is looking down	An Asian woman is holding a fur scarf
A little boy is wearing a green soccer strip and is running on the grass	There is no little boy wearing a green soccer strip and running on the grass
One man is running down the road	A man is running
There is no girl playing a flute	A girl is playing a flute
A child, who is small, is outdoors climbing steps outdoors in an area full of grass	A small child is outdoors climbing steps in a grassy area
The men are talking	Some old women are talking
The cat is looking out the window at the table on the perch	The cat perched on the table is looking out the window
A young girl is standing on one leg	A young female is dancing
People are riding and paddling a raft	Four people are floating on a raft
A football player is wearing black armbands	An American footballer is wearing the red and white strip
The cat is playing passionately with a watermelon	The cat is playing with a watermelon
A man is squatting in brush and taking a photo	A girl in gold and purple is holding a rainbow afghan
A person is pouring oil for cooking into a pot	A person is pouring cooking oil into a pot
A skilled person is riding a bicycle on one wheel	A person in a black jacket is doing tricks on a motorbike
A young girl in a blue shirt is walking on the sidewalk and holding up a pink sign	A young girl by a pink sign is holding up a blue shirt and is walking on the sidewalk
A large green ball is hitting a potato	A large green colored ball is hitting a potato
The little boy is sticking his tongue out for the camera and another boy is looking on	Two young boys are looking up at the camera and one is sticking out his tongue
The man is drawing	There is no man drawing
A girl with red hair and red eyebrows is in midspeech	The girl has red hair and eyebrows, several piercings in a ear and no tattoo on the back
A woman, who is seated, is singing a song and playing the guitar	A seated woman is singing a song and playing the guitar
A woman is slicing an octopus	An octopus is being sliced by a woman
A yellow dog is running on white snow on a very sunny day	A yellow dog is running on white snow on a sunny day
A little brown and white dog is running on the sidewalk	A little brown and white dog is running on the road
A woman is combing her hair	A woman is arranging her hair
A woman is cutting a lemon	A woman is cutting fruit
A woman is chopping up garlic	A woman is putting away the garlic
The snowboarder isn't leaping over white snow	A person who is practicing snowboarding jumps into the air
A man is praying fervently	A man is dancing
The woman is slicing cooked octopus	A woman is chopping up an octopus
A man in blue is riding a horse on a dirt road	A man in a blue cowboy hat is riding a white horse
The woman wearing silver pants, pink bellbottoms and a pink scarf is riding a bike	Pink bellbottoms and a pink scarf aren't to be worn by women with silver pants or bike riding people
The group of dim people is sitting in a room	A man and two women in a darkened room are sitting at a table with candles
An Asian man is dancing and three kids are looking	The children of a family are playing and waiting
A man in blue jeans is standing in front of a group of children beside a stone built house	A lady is standing on the street and is surrounded by school children
A blond child is going down a slide and throwing up his arms	A child with dark hair is going down a slide and throwing up his arms
Some women are dancing and singing 	A woman is dancing and singing in the rain
There is no woman putting meat in a pan	A woman is putting meat in a pan
There is no small bee landing on a bunch of yellow flowers	A bee is clinging to a yellow flower
A band is playing some instruments	Some instruments are being played by a band
A person with a red hooded jacket and a black backpack is walking near a rocky wall	A man in a red jacket and khaki pants is walking through an European state
A man is playing an acoustic guitar	The woman is not playing an electric guitar
There is no cat eating corn on the cob	A cat is eating some corn
A bike is being ridden over a monkey	A person is riding a dirt bike down a dirt hill
There is no man standing on a roof top and playing a violin	A man is standing on a roof top and playing a violin
A monkey is kicking at a person's glove	The monkey is practicing martial arts
A man and a woman are eating happily	A man and woman are talking
A man is playing flute	A man is playing a game with a ball
One man is climbing a cliff with a rope	A person is climbing a rock with a rope, which is pink
Few people are eating at red tables in a restaurant without lights	A large group of Asian people is eating at a restaurant
The meat is being dropped into a pan	Someone is dropping the meat into a pan
A man's white car is being driven away	The man is granting an interview
A baby is playing with a doll	A tiger cub is playing with a ball
A black dog is running in the grass	A dog, which is black, is running in the grass
A horse is tossing the cowboy wearing pants of blue and red color	A man is getting on a horse on a track laid in the wild
A person is slicing an onion	A person is cutting some ginger
A boy in a striped shirt is jumping in front of a water fountain	A boy in a striped shirt is jumping behind a water fountain
Two boys are laying in the ocean close to the beach	Two boys are laying in the water close to the beach
A girl is skipping rope on near a street	A girl is jumping rope on a sidewalk near a parking garage
A talk about an adult and a boy is given in the amphitheater	An adult is in the amphitheater and is talking to a boy
The man is denying an interview	The man is granting an interview
A man is squirting water into the mouth of a white dog with a squirt gun	There is no man spraying a super soaker into the mouth of a dog
The black and white dog is running in a green yard	A black and white dog is running outdoors
A karate practitioner is kicking at another man who is wearing protective boxing gloves	The man is kick boxing with a trainer
There is no young boy jumping in the air with his knees bent and arms spread	A person with a green shirt is jumping high over the grass
A young girl in blue is jumping in the air	The young girl in blue is jumping in the air
Four children are doing backbends in the gym	Four girls are doing backbends and playing outdoors
Some cameras are being burned by a person with a blow torch	The person is setting fire to the cameras
The puppy is playing with a plastic container	The puppy is not playing with a plastic container
Two children, who are small, are playing with a toy car in the street	A father is pushing his daughter on a go-kart and another girl is watching
A person is cutting an onion into pieces	A person is slicing a carrot into pieces
A man is opening a door	There is no man opening a door
A person is standing near a motorcycle	A person is chopping an onion
A blond girl is looking at the waves	A lady is surfing and riding a wave
A woman is resting her fingers on a table	A woman is tapping her fingers on a table
A boy wearing a striped shirt is running barefoot on the sandy hill	A boy is running through the sand
An onion is being sliced by a woman	The woman is cutting a carrot
The rider dressed in orange is driving a motorcycle on one wheel	A man on a yellow sport bike is doing a wheelie and a friend on a black bike is catching up
There is no one playing a piano	A man is playing a guitar
A group of students in uniforms is listening attentively at the front of the class	A classroom full of students is looking attentively in the same direction inside a bamboo structure
A man is walking down a road	A man is stopping in the middle of a road
The girl is cheering the man in the blue and white uniform	The girl in the blue and white uniform is cheering
A young girl with painted face is standing next to some other children	Children are being dressed in costumes and playing a game
Two people are sitting on a park bench on a hot day	Two people are sitting on a park bench on a sunny day
A white man is staging a hat and a playing guitar	A man in a white hat is playing guitar on stage
